1 1 1 1 1 1 1 1 1 1 1 1 1 1 1 1 1 1 1 1 1
1 0 1 2 2 2 0 0 0 0 1 0 0 0 0 0 1 0 0 4 1
1 1 1 1 1 2 1 1 1 0 1 0 1 1 1 0 1 1 1 0 1
1 2 1 0 1 2 1 0 1 0 1 0 1 0 1 0 1 0 1 0 1
1 2 1 1 1 2 1 1 1 0 1 0 1 1 1 0 1 1 1 1 1
1 3 2 2 2 3 0 0 0 0 0 0 0 0 0 0 0 1 0 0 1
1 2 1 1 1 0 1 0 1 1 1 1 1 0 1 0 1 1 1 0 1
1 2 1 1 1 0 1 0 1 1 1 1 1 0 1 0 1 1 1 0 1
1 2 2 2 2 2 1 0 0 0 1 0 0 0 1 0 0 0 0 0 1
1 1 1 1 1 0 1 1 1 0 1 0 1 1 1 0 1 1 1 1 1
0 0 0 0 1 0 1 0 0 0 8 0 0 0 1 0 1 0 0 0 0
0 0 0 0 1 0 1 0 1 1 1 1 1 0 1 0 1 0 0 0 0
1 1 1 1 1 0 1 0 1 0 1 0 1 0 1 0 1 1 1 1 1
0 0 1 0 0 0 0 0 1 0 1 0 1 0 0 0 0 0 1 0 0
1 1 1 1 1 0 1 0 1 1 1 1 1 0 1 0 1 1 1 1 1
0 0 0 0 1 0 1 0 0 0 0 0 0 0 1 0 1 0 0 0 0
0 0 0 0 1 0 1 0 1 1 1 1 1 0 1 0 1 0 0 0 0
1 1 1 1 1 0 1 0 1 1 1 1 1 0 1 0 1 1 1 1 1
1 0 0 0 0 0 0 0 0 0 1 10 0 0 0 9 0 0 0 0 1
1 0 1 1 1 0 1 1 1 7 1 0 1 1 1 0 1 1 1 0 1
1 0 0 0 1 0 0 0 0 0 0 0 0 0 0 0 1 0 0 0 1
1 1 1 0 1 0 1 0 1 1 1 1 1 0 1 0 1 0 1 1 1
1 1 1 0 1 0 1 0 1 1 1 1 1 0 1 0 1 0 1 1 1
1 0 0 0 0 0 1 0 0 0 1 0 0 0 1 0 0 0 0 0 1
1 0 1 1 1 1 1 1 1 0 1 0 1 1 1 1 1 1 1 0 1
1 6 0 0 0 0 0 0 0 0 0 0 0 0 0 0 0 0 0 5 1
1 1 1 1 1 1 1 1 1 1 1 1 1 1 1 1 1 1 1 1 1